NO ./src/assets/anime/no.xpm
SO ./src/assets/anime/so.xpm
WE ./src/assets/anime/we.xpm
EA ./src/assets/anime/ea.xpm

C 152,111,158
F 77,75,158

111111111111111
1000011110000011111
10E0000000000000001
1000000001111111111
1111111111